A Pleasant Stroll
........F.........
..................
...M.MMMMM........
...M........M.....
...M....S...M.....
...M.... ...M.....
...M.... ...M.....
........ .........
..................