The Garden Path
.O.MMM.OOO. ....M.
.............M....
..OOOO....O.......
... ..  .......O..
S.. ...M.......O..
...M......M....O..
. ...OOO.    .....
...M..........M...
........M....F....